########
#J..P..#
#.###..#
#..@#.@#
#@#.@..#
#....#@#
########
